
You = tu
with = con
for = para
understand = entiendo
speak = hablo
from = soy
welcome = bienvenido
please = por favor
and = y
english = ingles
small = pequeño
need = necesitar
large = grande
rice = arroz
have = tener
or = o
you're welcome = de nada
thank you/thanks = gracias
goodbye = adios
phone = telefono
number = numero
what = que
address = direccion
last name = apellido
good = bueno
friend = amigo
excuse me = disculpa
too = tambien
to = a
first = primero
restaurant = restaurante
is = es
sorry = perdon
airport = aereo puerto
reservation = reservacion
want = desear
in = en
where = donde
the = la/el
see you later = nos vemos/hasta pronto
passport = pasaporte
live = vivo
parents = padres
right = correcto
help = ayuda
restroom = baño
is = esta
this = esto
like = gusta
read = leer
doig = hacer
riding = montar
his = su 
Great = excelente
can = puede  
hot = caliente
cold = frio
old = antiguo
its = su
it's = es
expensive = caro
clothes = ropa
wife = esposa
husband = esposo
brush = cepillo 
clock = reloj
spell = deletrea
same = mismo/a  
learning = aprendizaje
learn = aprender
candle = candela
doughnut = rosquilla 
donunt = dona
flower = flor
grass = cesped
hand = mano
ice cream = helado
notebook = cuaderno
sand = arena 
umbrella = sombrilla 
key = llave
quiz = prueba
rose = rosa 
violin = violin
of = de
one hundred = cien 
one thousand = mil 
one million = millon 
one billion = billon    
o'clock = en punto
only = solamente
drive = conducir
driver = conductor
cash = efectivo
say = decir     
know = saber 
there = alli 
sank = se hundio
decade = decada
many = muchos
century = siglo 
midday = mediodia
cent = centavo
dollar = dolar
cost = costaba
sleepy = sueño 
sleep = dormir
can = puede
lie = mentir
until = hasta
winter = invierno
summer = verano
spring = primavera
autumn/fall = otoño
it = eso 
do = hacer      
say = decir
little = poco/pequeño
pregnant = embarazado  
greeting = saludo
farewell = despedida
has = tiene 
bookstore = libreria
bakery = bakery
cine = movie theater 
library = biblioteca