
how about you? = y tu?
that is right = asi es/ eso es correcto
can you speak more slowly please? = puedes hablar más despacio por favor?
hello everyone = hola a todos
can you repeat please = puedes repetir por favor
you can call me = puedes llamarme
have a nice day = que tengas un buen dia
How are you? = Como estas?
I’m well = Estoy bien (Estar bien de salud)
I’m great = Estoy genial
I’m tired = Estoy cansada
Why are you tired? = ¿Por que estas cansada?
It is early here = Es temprano aqui
Hey everyone = Hola a todos
I’m wonderful = Estoy de maravilla
I’m good = Estoy bien (Estar contento)
I’m sad = Estoy triste
Why are you so sad? = ¿Por qué estás tan triste?
Because my dog is sick = Porque mi perro esta enfermo
I’m sorry = Lo siento
It’s ok = Está bien
Hey! = Hola
I’m stressed today = Estoy estresada hoy
Why are you stressed? = ¿Por qué estas estresada?
I have a lot of work = Tengo mucho trabajo
I’m busy = Estoy ocupada
Why are you busy? = ¿Por qué estas ocupada?
I’m planning a big party = Estoy planeando una gran fiesta
Sounds fun = Suena divertido
Yeah = Si
Nice talking to you = Encantado de hablar contigo
Bye = Adiós
See you soon! = ¡Nos vemos pronto!
it's a pleasure too = es un placer tambien
I’m sick = Estoy enferma
Oh! sorry. I’m tired today. = Oh! lo siento. Hoy estoy cansado.
Can you spell that for me? = ¿Puedes deletrearme eso?
Can you tell me a little more = ¿Puedes contarme un poco más sobre ti?
Can you remind me? = ¿Puedes tu recordarme?
Are you married or single? =  ¿Estas casado o soltero?
Oh no what happened? = oh no que paso?
not working = no funciona
What can we do? I don’t know = ¿Qué podemos hacer? No sé
